***********************************G***
*       *          *       *          *
**** ***** ************ ***** *********
*     *            *     *            *
** ****** ***** ***** ****** ***** ****
*           *                  *      *
**** ***** ************ ***** *********
*       *       *          *          *
**** ***** ************ ***** ****** **
*     *            *     *       *    *
** ****** ***** ***** ****** ***** ****
*           *                  *      *
**** ***** ************ ***** *********
*     *            *     *            *
** ****** ***** ***** ****** ***** ****
*           *                  *      *
**** ***** *******S**** ***** *********
*       *       *          *          *
**** ***** ************ ***** ****** **
*     *            *     *       *    *
** ****** ***** ***** ****** ***** ****
*           *                  *      *
**** ***** ************ ***** *********
*     *            *     *            *
** ****** ***** ***** ****** ***** ****
*           *                  *      *
***************************************