***************************************
*       *          *       *         G*
**** ***** ************ ***** *********
*     *            *     *            *
** ****** ***** ***** ****** ***** ****
*           *                  *      *
**** ***** ************ ***** *********
*       *       *          *          *
**** ***** ************ ***** ****** **
*     *            *     *       *    *
** ****** ***** ***** ****** ***** ****
*           *                  *      *
**** ***** ************ ***** *********
*     *            *     *            *
** ****** ***** ***** ****** ***** ****
*           *                  *      *
**** ***** ************ ***** *********
*       *       *          *          *
**** ***** ************ ***** ****** **
*     *            *     *       *    *
** ****** ***** ***** ****** ***** ****
*           *                  *      *
**** ***** ************ ***** *********
*     *            *     *            *
** ****** ***** ***** ****** ***** ****
*S          *                  *      *
***************************************